Error	错误
already	已经
register	注册
luaOnDestroy	lua打开销毁
this	这
is	是
exception	异常
Exception	异常
Invalid	无效
invalid	无效
sequence	序列
escape	避开
child	子
index	索引
filename	文件名字
unknown	未知
method	方法
traceback	回调返回
stack	堆栈
expected	预料
near	附近
on	正在
syntax	语法
error	错误
string	字符串
chunk	块
LuaException	lua异常
malformed	格式不正确
pattern	模版
missing	缺少
function	函数
in	在
unexpected	意外
symbol	符号
arguments	理由
Argument	理由
range	行
main	主要
attempt	尝试
to	到
a	一个
value	值
field	字段
call	调用
LuaException	Lua异常
close	结束
at	问题在
line	行
valuestack	根对象
global	全局变量
Access	访问
the	那
path	路径
denied	拒绝
filename	文件名
unknown	未知
concatenate	链接
local	局部变量
try	尝试
get	获取
throw	抛出
has	它
been	已经
thrown	抛出
by	被
target	目标
invocation	调用
an	一个
of	属于
Parameter	参数
name	名字
index	索引
wrapper managed-to-native	封装管理到本地
perform	进行
arithmetic	算术
SyncSave	同步保存
Save	保存
OnEnter	进入
Step	帧间隔
OnLoad	加载
SyncLoad	同步加载
SetHotKey	设置热键
OnHotKey	激活热键
OnSyncSave	同步保存
HotKey	热键
Init	初始化
OnSave	保存
Load	加载
OnAfterLoad	之前加载
OnLeave	离开
OnBeforeInit	之前初始化
OnStep	帧间隔
OnInit	初始化
OnSyncLoad	同步加载
Leave	离开
BeforeInit	之前初始化
Enter	进入
AfterLoad	之前加载
NeedSyncData	需要同步数据
OnSetHotKey	设置热键
GetWindow	获取窗口
table	表
enter	进入
false	假
boolean	逻辑型
CreateWindow	创建窗口
init	初始化
true	真
WindowBase	窗口根本
NewClass	新建类
SetHtml	设置网页html
OnHide	隐藏
Show	显示
AddObjectFromUrl	添加对象到窗口
OnShown	显示
OnShowUpdate	显示更新
OnEventListener	事件监听
OnUpdate	更新
AddButton	添加按钮
SetTitle	设置标题
Hide	隐藏
AddLable	增加标签
SetSize	设置尺寸
OnObjectEvent	对象事件
window	窗口
Wnd	窗口
userdata	C#数据
